3
UUUUUUUUUUUUUUUUUUUU
UBBBBUUBBBBUUUBBBBUU
UBUUUBUBUUUBUBUUUUUU
UBUUUBUBUUUBUBUUUUUU
UBBBBUUBBBBUUBUBBBUU
UBUUUBUBUUUBUBUUUUBU
UBUUUBUBUUUBUBUUUUBU
UBBBBUUBBBBUUUBBBBUU
UUUUUUUUUUUUUUUUUUUU
        ##          
