 ##      ##      ## 
BBBBBBBBBBBBBBBBBBBB
BXXXXXXXXXXXXXXXXXXB
BXXXXXXXXXXXXXXXXXXB
BXXXXXXXXXXXXXXXXXXB
BXXXDXXXXXXXXXXDXXXB
BXXXXXXXXXXXXXXXXXXB
BXXXXXXXXXXXXXXXXXXB
BXXXXXXXXXXXXXXXXXXB
BXXXXXXXXXXXXXXXXXXB
BXXXXXXXXXXXXXXXXXXB
BXXXXXXXXXXXXXXXXXXB
BXXXXXXXXXXXXXXXXXXB
BXXXXXXXXXXXXXXXXXXB
BXXXDXXXXXXXXXXDXXXB
BXXXXXXXXXXXXXXXXXXB
BXXXXXXXXXXXXXXXXXXB
BXXXXXXXXXXXXXXXXXXB
BBBBBBBBBBBBBBBBBBBB
 ##      ##      ## 
