1
                         
           ###           
 AAAAAAAAAAAAAAAAAAAAAAA 
AAAAAAAABBBBAAAAAABBBBAAA
AAAAAAAAABAAAAAAAABAABAAA
AAAAAAAAARRRRRRRRRRABBAAA
AAAAAAAARRAAAAAARRRAAAAAA
AAABBBBRRRAAAAARRBRBBBAAA
AABBBBRRBRRAAARRBBRRBBBAA
ABBBBRRBBBRAARRBBBBRBBBBA
ABBBBRBBBBRARRABBBBRBBBBA
ABBBBRRRRRRBRAABBBBRBBBBA
ABBBBBBBBBABAAABBBBBBBBBA
ABBBBBBBBBABAAABBBBBBBBBA
AABBBBBBBAAAAAAABBBBBBBAA
AAABBBBBAAAAAAAAABBBBBAAA
 AAAAAAAAAAAAAAAAAAAAAAA 
