5
         ###        
      BBBBBBBBB     
        BMBMB       
         BBB        
         BBB        
        BRRRB       
   BBBBBBBBBBBBBB   
  BRRRRRRRRRRRRRRB  
 BRRRRRRRRRRRRRRRRB 
BRRRBBBRBBBBRBBBRRRB
BRRBAAABAAAABAAABRRB
BRRBAAABAAAABAAABRRB
BRRRBBBRBBBBRBBBRRRB
BRRRRRRRRRRRRRRRRRRB
BRRRRRRRRRRRRRRRRRRB
BRRRRRRRRRRRRRRRRRRB
BRRRRRRRRRRRRRRRRRRB
 BBBBBBBBBBBBBBBBBB 
  BDB BDB   BDB BDB 
   B   B     B   B  
