13
   ###    
AAAAAAAAA 
ADAAAAADA 
DBDAAADBD 
DBBBBBBBD 
DBDAAADBD 
ADAAAAADA 
AAAAAAAAA 
          
          
