7
AAAAAAAAAAAAAAAA
AAWWWWWWWWWWWWAA
AWAAAAAAAAAAAAWA
AWAAAAWWWWAAAAWA
AWAAAAWAAWAAAAWA
AWAAAAWAAWAAAAWA
AWAAAAWWWWAAAAWA
AWAAAAWAAAAAAAWA
AWAAAAWAAAAAAAWA
AWAAAAWAAAAAAAWA
AWAAAAWAAAAAAAWA
AWAAAAWAAAAAAAWA
AWAAAAAAAAAAAAWA
AWAAAAAAAAAAAAWA
AAWWWWWWWWWWWWAA
AAAAAA###AAAAAAA
