15
BBBBBBBBBB
BBBBMBMBBB
BBBMMMMMBB
BBMBMBMBBB
BBMBMBMBBB
BBBMMMMMBB
BBBBMBMBMB
BBBBMBMBMB
BBBMMMMMBB
B##BMBMBBB
