4
                 
 NNNNBBBBBBBNNNN 
 NNNNNBDDSBNNNNN 
 NNNNNBDDSBNNNNN 
 NNNNBDDDDSBNNNN 
 NNNNBDDDDSBNNNN 
 NNNBDDDDDDSBNNN 
 NNNBDDDDDDSBNNN 
 NNBCCCCCCCCABNN 
 NNBCCCTCCCCABNN 
 NBCCCCCCCCCCABN 
 NBCCCCCCCTCCABN 
 NBCCTCCCCCCCABN 
 NBCCCCCCCCCCABN 
 NBAAAAAAAAAAABN 
 NNBBBBBBBBBBBNN 
       ###       
