LLLLLLLLLL
LLLLLL###L
LLLLLL#F#L
LLLLLL#F#L
LLLLLL#F#L
LLLLLL#F#L
LLLLLL#F#L
LLLLLL###L
LLLLLLLLLL
LLLLLLLLLL
