2
AAAAAAAAAAAAAAAA
AAAAAAAAAOOAAAAA
AAAAAAAOOMMOAAAA
AAAAAOOMMMMMOAAA
AAAOOMMMMYMMMOAA
AOOMMMMMMMYMMMOA
OMMMMMMMMMMYMMMO
OOMMMMMMMMMMMOOS
OSOMMMMMMMMOOSWS
OWSOMMMMMOOSSWOO
AOWSOMMOOSSWOOAA
AAOWSOOSSWOOAAAA
AAAOWSSWOOAAAAAA
AAAAOWWOAAAAAAAA
AAAAAOOAAAAAAAAA
AAAAAAAAAAAAAAAA
  ##        ##  
