9
BBBB            
BMBRBBBBB       
BMBRRBMMMBBBBB  
BMMBBMMMMMMMMBBB
 BMMMMMMMMBBMBUB
 BMMMMMMMBRRBBUB
 BMMMMMMMBRRBBUB
 BMBBMMMMMBBMBUB
  BRRBMMMMMMBUUB
  BRRBMMMMMBUUB 
  BBBMMMMMBUUB  
   BMMMMMBUUB   
   BMMMBBUUB    
   BBBBUUUB     
   BUUUUBB      
   BBBBB##      
