15
                              
RRRRRRRRRRRRRRRRRRRRRWWWWWWWWW
RWWWWRWWWWRRWWRRWWWWRWWWGGGWWW
RWRRRRWRRWRWRRWRWRRWRWWGWWWGWW
RWRRRRWRRWRWRRWRWRRWRWGWWGWWGW
RWWWWRWWWWRWWWWRWWWWRWGWGGGWGW
RRRRWRWRRRRWRRWRWRWRRWGWGGGWGW
RRRRWRWRRRRWRRWRWRRWRWWGWGWGWW
RWWWWRWRRRRWRRWRWRRWRWWWGGGWWW
RRRRRRRR##RRRRRRRRRRRWWWWWWWWW
