WWWWWWWWWW
WWWWBBWWWW
WWWBFFBWWW
WWWBFFBWWW
WWWBFFBWWW
WWWBFFBWWW
WWWBFFBWWW
WWWBFFBWWW
WWWWBBWWWW
WWWWWWWWWW
WWWWBBWWWW
WWWBFFBWWW
WWWBFFBWWW
WWWWBBWWWW
WWWWWWWWWW
    ##