8
               
    ###        
   BBBBB       
 BBEUUEUBB     
BUUUEUUEUUB    
BBEUUEEUUBB BB 
BLBBBBBBBLBBLLB
BLLLLLLLLLBLBLB
BLLLLLLLLLBBBLB
BLLLLLLLLLBBBLB
BLLLLLLLLLBLBLB
BLLLLLLLLLBBLLB
BLLLLLLLLLB BB 
 BBLLLLLBB     
   BBBBB       
